R 1280 960

NO ./textures/mossy.xpm
SO ./textures/bluestone.xpm
WE ./textures/purplestone.xpm
EA ./textures/YellowSandStone.xpm
S ./textures/pillar.xpm


F 0,254,210
C 200,130,25


        1111111111111111111111111
        1000000000110000000000001
        1011000001110000000000001
        1001000000E00000020000001
111111111011000001110000000000001
110111111111110110000000001000001
1000000001 1000001110111111111111
1111011111 111011100000010001
11110111111111011101010010001  111
11000000110101011100000010001  101
10000000000000001100000000001  111
10000000000000001101010010001
1100000111010101111101111000111
11110111 1110101 101111010001
11111111 1111111 111111111111
1               1                1